#######################################
# Syntax Coloring Map For CIoTHubDevice
#######################################

#######################################
# Datatypes (KEYWORD1)
#######################################

IoTHubDevice	KEYWORD1
IoTHubMessage	KEYWORD1
MapUtil		KEYWORD1

#######################################
# Methods and Functions (KEYWORD2)
#######################################

GetHostName	KEYWORD2
GetDeviceId	KEYWORD2
GetVersion	KEYWORD2
SetMessageCallback	KEYWORD2
SetConnectionStatusCallback	KEYWORD2
SetDeviceMethodCallback	KEYWORD2
SetUnknownDeviceMethodCallback	KEYWORD2
GetHandle	KEYWORD2
WaitingEvents	KEYWORD2
WaitingEventsCount	KEYWORD2
GetLogging	KEYWORD2
SetLogging	KEYWORD2
SendEventAsync	KEYWORD2
DoWork	KEYWORD2
CreateMap	KEYWORD2
Add	KEYWORD2
AddOrUpdate	KEYWORD2
ContainsKey	KEYWORD2
ContainsValue	KEYWORD2
GetValue	KEYWORD2
GetCString	KEYWORD2
GetString	KEYWORD2
GetByteArray	KEYWORD2
GetContentType	KEYWORD2
SetContentTypeSystemProperty	KEYWORD2
GetContentTypeSystemProperty	KEYWORD2
GetProperties	KEYWORD2
SetProperty	KEYWORD2
GetProperty	KEYWORD2
SetMessageId	KEYWORD2
GetMessageId	KEYWORD2
SetCorrelationId	KEYWORD2
GetCorrelationId	KEYWORD2

#######################################
# Constants (LITERAL1)
#######################################

IOTHUBMESSAGE_DISPOSITION_RESULT	KEYWORD3
IOTHUB_CLIENT_CONFIRMATION_RESULT	KEYWORD3
IOTHUB_CLIENT_CONNECTION_STATUS	KEYWORD3
IOTHUB_CLIENT_CONNECTION_STATUS_REASON	KEYWORD3
MQTT	KEYWORD3
IOTHUB_CLIENT_LL_HANDLE	KEYWORD3
IOTHUB_CLIENT_RESULT	KEYWORD3
MessageCallback	KEYWORD3
ConnectionStatusCallback	KEYWORD3
DeviceMethodCallback	KEYWORD3
UnknownDeviceMethodCallback	KEYWORD3
IOTHUB_MESSAGE_HANDLE	KEYWORD3
MAP_HANDLE	KEYWORD3
IOTHUBMESSAGE_ACCEPTED	KEYWORD3
IOTHUBMESSAGE_REJECTED	KEYWORD3
IOTHUBMESSAGE_BYTEARRAY	KEYWORD3
IOTHUBMESSAGE_STRING	KEYWORD3
IOTHUB_CLIENT_CONFIRMATION_OK	KEYWORD3
IOTHUB_CLIENT_CONFIRMATION_BECAUSE_DESTROY	KEYWORD3
IOTHUB_CLIENT_CONFIRMATION_MESSAGE_TIMEOUT	KEYWORD3
IOTHUB_CLIENT_CONFIRMATION_ERROR	KEYWORD3
IOTHUB_CLIENT_CONNECTION_AUTHENTICATED	KEYWORD3
IOTHUB_CLIENT_CONNECTION_UNAUTHENTICATED	KEYWORD3
IOTHUB_CLIENT_CONNECTION_EXPIRED_SAS_TOKEN	KEYWORD3
IOTHUB_CLIENT_CONNECTION_DEVICE_DISABLED	KEYWORD3
IOTHUB_CLIENT_CONNECTION_BAD_CREDENTIAL	KEYWORD3
IOTHUB_CLIENT_CONNECTION_RETRY_EXPIRED	KEYWORD3
IOTHUB_CLIENT_CONNECTION_NO_NETWORK	KEYWORD3
IOTHUB_CLIENT_CONNECTION_COMMUNICATION_ERROR	KEYWORD3
IOTHUB_CLIENT_CONNECTION_OK	KEYWORD3
IOTHUB_CLIENT_OK	KEYWORD3